1111111111111111111
1P00C0000000C000001
1111101111101111101
1000001000000000101
1111011111111011101
1C000000C000000C001
1111011111111011101
1000001000000000101
1011101111101111101
10E00000000C0000001
1111111111111111111
