NO ./textures/north.xpm
SO ./textures/south.xpm
WE ./textures/west.xpm
EA ./textures/east.xpm
F 139,69,19
C 135,206,235
11111
N0001
10101
11111
