NO ./textures/north.xpm
SO ./textures/south.xpm
WE ./textures/west.xpm
EA ./textures/east.xpm
F 139,69,19
C 135,206,235
11111
1X001
10N01
11111
