
			NO ./textures/north.xpm



SO ./textures/south.xpm



WE ./textures/west.xpm



EA ./textures/east.xpm



     F      139,69,19





C 135,206,235








111111101
110010001
101010101
100000001
111011101
100000001
101010101
100N00001
111111111
