NO ./textures/north.xpm
SO ./textures/south.xpm
WE ./textures/west.xpm
EA ./textures/east.xpm
F 139,69,19
C 135,206,235
111111
1N0001
101011
100001
111111
