NO ./textures/north.xpm
SO ./textures/south.xpm
WE ./textures/west.xpm
EA ./textures/east.xpm
F 139,69,19
C 135,206,235
1111111111111
1000100S00001
1010101011101
1010001000001
1111111111111
